军事贸易	军贸
厄尔尼诺	厄尔尼诺现象
军训	军事训练
全国人民代表大会会议	全国人大会议
军事哲学	军事辩证法
溃堤	溃决
宇航员训练	航天员训练
战役自动化指挥系统	战役指挥自动化系统
装备工艺定型	工艺定型
兵种军邮勤务	军邮
技改	技术改造
军人死亡抚恤	军人抚恤
卫生间	厕所
工商	工商业
兵器	武器
接密关系	内线
汇价	汇率
技术服务	科技服务
电视主持人	电视节目主持人
战地	战场
烟草业	烟草工业
价格水平	物价水平
长话	长途电话
建行	中国建设银行
声屏蔽	隔声
检察机关	国家检察机关
国际船舶安全运行与防止污染管理规则	国际安全管理规则
文件解密	解除密级
空气温度	气温
顾客	用户
文学鉴赏	文学欣赏
冷屏蔽	隔热
中药饮片	饮片
禁止使用的武器	禁用武器
黄箱补贴	可诉补贴
办学道路	办学方针
卡通画	动画
仪器厂	仪器仪表厂
邮政车	邮政车辆
粮油出售	粮油销售
收支结合	收支挂钩
共产主义青年团	共青团
后方勤务体制	后勤体制
军人家属	军属
收容遣送站	救助管理站
党的工作委员会	党工委
农机具	农业机械
战略自动化指挥系统	战略指挥自动化系统
武器装备购置费	装备购置费
邮票展览	邮展
喇嘛教	藏传佛教
起义人员	起义投诚人员
检查机关	国家检察机关
栽植	种植
劳动教养	劳教
地下铁路	地铁
央行	中国人民银行
市场竞争能力	市场竞争力
人武部	人民武装部
企业集团	集团企业
舰艇定位	舰船定位
战略格局	战略形势
集贸	集市贸易
国营工业	国有工业
家财保险	家庭财产保险
依赖关系	相互关系
国家级文物	国家重点文物
军事科学研究	军事科研
正规化执勤	正规执勤
国家军制	军制
可维修性	维修性
恐怖集团	恐怖组织
宗教院校	宗教学校
安钉子	渗透
地方军	地方部队
国防领导管理体制	国防领导体制
股份有限公司	股份公司
印刷业	印刷工业
农业贸易结合	农贸结台	农贸结合
储运	储备运输
地矿	矿产
军队科学技术进步奖	军队科技进步奖
防热	隔热
群众感谢信	感谢信
汇兑比率	汇率
军产保护法	军事设施保护法
企业经营方针	企业经营
卫星通信地球站	地球站
商品供给	商品供应
偿还能力	偿付能力
调查材料	调研材料
惩办	惩治
商品制造	商品生产
委务会议	委员会会议
军事卫星	军用卫星
港澳台合资经营企业	港澳台商企业
军队纪委	军队纪律检查委员会
冷蛋子	冰雹
边防工作政策规定	边防政策
倒卖车票	倒票
物资存储	物资储备
全军体育运动大会	全军运动会
裁谈	裁军谈判
解密	解除密级
企业经营计划	企业经营
消费能力	消费力
保护臭氧层	臭氧层保护
全宗群	全宗汇集
常务委员会会议	常委会议
军队政治部门	军队政治机关
纪律检查委员会	纪委	纪检
展卖	展销
绿色产业	环保产业
人民防空	人防
微量降雨	零星小雨
武器装备编配标准	装备编配标准
边界谈判	边界问题谈判
水面舰船	水面舰艇
预备力量动员	后备力量动员
高新技术企业	高技术企业
军事援外经费	军援经费
东南亚国家联盟	东盟
思想理论研究	理论研究
细菌武器	生物武器
专才	专门人才
保税	保护关税
军队指挥自动化系统	自动化指挥系统
军民共建精神文明	军民共建
全国人民代表大会常务委员会委员长会议	委员长会议
受审军官	受审查军官
撤销职务	撤职
市内电话业务资费	市话资费
水陆两栖飞机	水陆两用飞机
军事部门	军事机关
分区征集	划区征集
军援协议	军援协定
大气环流形势	天气形势
深弹探测	深水炸弹探测
干燥度	干燥指数
家庭轿车	家用轿车
农林牧结合	农业综合发展
信息技术、信息系统	内部网
国防经济	军品
造纸设备	造纸机械
文件传真机	传真机
地雷探测	探雷
电话会	电话会议
化学防护	化学武器防护
造船厂	船厂
雷达抗干扰	雷达反干扰
公交	公共交通
购置	购买
保密督察	保密检查
白霜	霜
标题法	主题法
高新企业	高技术企业
最高统帅部	统帅部
零件	零部件
特务	间谍
核物理	核物理学
人武	武装力量
外国军事学员	外军学员
基本建设费用	基建费
尘暴	沙尘暴
信用社	信用合作社
越界	越境
中共中央政治局扩大会议(1959)	庐山会议(1959)
检举	举报
木材工业	木材加工业
家用电脑	微型计算机
武力干涉	武装干涉
军队杂志	军队期刊
价格指数	物价指数
驻军式训练	野营训练
复垦开发	土地复垦开发
行李包裹	行李
航次	航班
中等医学教育	医学教育
色情出版物	淫秽出版物
抚慰金	抚恤费
军事工业	国防工业
膨胀性财政政策	扩张性财政政策
国家政权	政权
防震结构	抗震结构
恢复外文关系	复交
整党	党的整顿
原油	石油
军工产品出口法规	军品出口法规
中国人民解放军	解放军
湿润系数	湿润指数
“四五”事件(1976)	天安门事件(1976)
平反冤假错案	平反
海外华人	华人
玉蜀黍	玉米
调整工资	工资调整
档案裱糊	档案修裱
猎枪管理	猎枪弹具管理
侵略行动	侵略
解放台湾	台湾回归
航海标态	航标
边境游	边境旅游
军装	军服
削价	降价
核事故应急救援	核事故救援
乡村绿化	农村绿化
无偿军事援助	无偿军援
中国共产党中央委员会全体会议	中央全会
技术密集列产业	高新技术产业
人民武装部	人武部
学术争论	学术讨论
部队部署	兵力部署
陆棚	大陆架
空中交通管制工作	空管工作
文献检索	检索
部分动员	局部动员
和平统一	和平统一问题
赤道锋	热带辐合带
导游证	导游资格证
矿产业	采矿业
党务	党务工作
电视节目	广播电视节目
中央顾问委员会委员	中顾委委员
化学制品制造业	化学制品业
杀手锏武器装备	杀手锏装备
消防设备	消防器材
侵略行径	侵略
麻醉药	麻醉剂
行管	行政管理
调车	车辆调度
中央处理器	CPU
周围介质条件下试验	环境试验
内核	内部审计
统一购买	统购
军事体育运动	军事体育
国家债券	国库券
科教兴县	科教兴国战略
联合收割机	联合收获机
人大常委委员	人大常委
环境保护产业	环保产业
反恐	反恐怖活动
军教片	军教影片
污水	废水
投敌叛变	叛变
武装组织	武装力量
外国语	外语
痕迹检查	迹检
光学反干扰	光电反干扰
参考材料	参考资料
积极干扰	有源电子干扰
工作委员会	工委
文职	文职干部
移植器官	器官移植
全民所有制企业	国有企业
全民义务植树	义务植树
研究试验	研制试验
小银行	小金库
气象管理局	气象局
大气湿度	湿度
检务	检察业务
任职资格	任职条件
生活废水	生活污水
羁押罪犯	羁押
社会生产力	生产力
移动台	移动电台
无产阶级	工人阶级
外科手术式战争	局部战争
拉练	野营训练
筹资	集资
生产手段	生产资料
热带辐合区	热带辐合带
政治局势演变	政局演变
出租车	出租汽车
手提电脑	笔记本电脑
溃坝	溃决
英模	英雄模范
药学	药物学
残废军人	残疾军人
思想政治教育	思想教育
震后重建	防震减灾
技术政策	科技政策
仪表厂	仪器仪表厂
作战结果	战果
中央银行	中国人民银行
遥测术	遥测
电子战支援侦察	电子对抗支援侦察
枪械工业	兵器工业
处置突发事件任务	处突任务
遗失	丢失
待命全权大使	大使
干部考核	干部考评
电子战支援	电子对抗支援侦察
强雷暴	强风暴
海域	海洋区域
专门档案	专业档案
人民防空警报	人防警报
联合后勤	联勤
人代会	人大
假币	假钞
非法行为	违法犯罪行为
小钱柜	小金库
军事运筹理论	军事运筹学
无偿献血	献血
观看淫秽影视	观看淫秽物品
党的三大作风	三大作风
军地两用人才培养	两用人才培养
挂账	赊账
调拨价格	调拨价
反走私	打击走私
审定	审查
扶持贫困户	扶贫
兵力调动	部队调动
新寄生虫	工业间谍
铁道养护	铁路养护
化纤工业	化学纤维工业
反革命罪	危害国家安全罪
水产机械	渔业机械
大田作物	禾谷类作物
武装	武装力量
调防	部队调动
数字地面高程模型	数字高程模型
经济发展计划	国民经济计划
最有希望输出产业	环保产业
电子抗击干扰	反电子干扰
技术作物	经济作物
水下反射导弹	潜射导弹
植物散发	植物蒸腾
边界协定	边界条约
空中交通管制	空中管制
群众防卫	民防
圣战	宗教战争
申明书	声明
快讯	快报
共产土义精神	共产主义道德
军事经济	国防经济
中小企业	中小型企业
采盐业	制盐工业
全国人大常委会委员长	委员长
军用车	军用车辆
预备力量建设	后备力量建设
震害	地震灾害
都市绿化	城市绿化
常委	常务委员
整体保障	综合保障
军事法律制度	军事法制
国防精神	国防观念
薪金标淮	工资标准
交易合同	贸易合同
情况摘报	情况通报
常备军	正规军
政治协商会议	政协
提职	晋职
电子战支援措施	电子对抗支援侦察
干道	干线道路
分组交换公用数据网	公用分组交换网
体育工作队	体工队
地形测绘	地形测量
长途自动电话业务	长途直拨电话业务
土地使用	土地利用
企业倒闭	企业破产
直接营销	直销
农行	中国农业银行
经济处分	经济处罚
军控	军备控制
制作贩卖淫秽物品	制售淫秽物品
水保林	水土保持林
信贷计划管理体制	信贷资金管理体制
存贮设备	存储设备
专卖店	商店
供大于求	供过于求
人民武装	武装力量
安检	安全检查
城市防空袭	城市防空
共产主义精神	共产主义道德
运力	运输能力
航天飞行员训练	航天员训练
联大	联合国大会
营养液栽培	无土栽培
航空事故	飞行事故
七一党的生日	七一建党纪念日
军体活动	军事体育
运动卫生	体育卫生
接敌关系	内线
军事指挥机关	指挥机关
节约用水	节水
科技兴国	科教兴国战略
强制保险	法定保险
军事代表	军代表
专门款项	专款
四五事件(1976)	天安门事件(1976)
邮资	邮政资费
种	物种
仿真训练	模拟训练
组织沿革	组织史
武器装备配套	装备配套
中层人民法院	中级人民法院
四清运动	社教
移动野营训练	野营训练
观看	观摩
全面动员	总动员
军队营区	军事社区
运输业	交通运输业
作战情况	战况
科技服务业	技术服务业
捐献遗体	遗体捐献
赤道辐合区	热带辐合带
中共中央纪律检查委员会常务委员全体会议	中央纪委常委会议
精确度	精度
水能资源	水力资源
轻工机械	轻工业机械
医保	医疗保险
党员条件	党员标准
特种挂号信函	特挂信函
印染设备	印染机械
保险费用	保险费
防范犯罪	预防犯罪
软件设计	软件开发
战备储备粮	战备粮
技术交流	科技交流
函件	信件
军事发展史	军事史
国体	国家制度
西部	西部地区
解放军院校	军队院校
摄影器材	摄影设备
医学	医药学
审计建议	审计意见
边贸管理	边境贸易管理
提议	建议
禁运武器	武器禁运
行军式训练	野营训练
防空导弹	地空导弹
国外旅游	出国旅游
表格	表
患病率	发病率
军队发展史	军史
仪器仪表制造业	仪器仪表工业
联合国贸易和发展会议	联合国贸发会	联台国贸发会
港台合资经营企业	港澳合商企业
爱国卫生	卫生
卫生计划	卫生规划
民兵分队训练	民兵训练
国防理论、政策	国防战略
水利资源	水资源
优秀人民警察	优秀民警
精简调整	精简整编
政治局势动荡	政局动荡
目标顾客	目标用户
扶贫工作	扶贫
广播彩色电视	电视广播
细菌武器防护	生物武器防护
防卫驻在官	武官
流行性出血热	出血热
反恐战争	反恐怖战争
个体工商户	个体户
广播国际电视	电视广播
合伙企业	合伙制企业
冰球运动	冰球
自动翻译	机器翻译
军事制度	军制
光缆	通信光缆
武器采办	武器装备采购
文化网站	文化站
大米	稻米
证券营业部	证券公司营业部
百花齐放百家争鸣	双百方针
家政服务业	居民服务业
炒买炒卖外汇	外汇交易
国内贸易	商业
劳务出国	劳务输出
雹暴	强风暴
最大航程	航程
会见	会晤
施政演说	工作报告
中央纪律检查委员会	中纪委
洽谈	谈判
鞋帽制造业	鞋帽工业
裁减军备会议	裁军谈判
少年儿童读物	少儿读物
装修房屋	房屋装修
不可见度	能见度
七号公共信道信令方式	七号信令
火车头	机车
积压品	积压物资
软件产业	软件业
爱护人民	拥政爱民
虫灾	病虫害
土豆	马铃薯
党的纪律处分	党纪处分
航运资源	水运资源
浮动价格	浮动价
买卖	交易
技术发展规划	科技发展规划
伤病员转送	伤病员后送
武器装备订货	装备订货
冶炼设备	冶金设备
外商独资企业	外商企业
照像	摄影
行政严重警告	严重警告
增盈	盈余
特种车	特种车辆
军制、军队管理	安全制度
武力占领	军事占领
医药制造业	医药工业
双拥活动	双拥工作
医院设备	医院设施
国防开支	国防支出
防务决算	国防决算
公文解密	解除密级
漂流旅游	漂流
统支	统收统支
舰船补给作业	舰艇补给作业
民防工程	人防工程
教练飞机	教练机
大地网	大地控制网
统计表	统计报表
反雷达干扰	雷达反干扰
石油价格	油价
桑业	蚕桑业
麻醉品	麻醉剂
分组交换数据网	分组交换网
收容遣送	救助管理
吸收外资	利用外资
决议案	决议
冶金	冶金工业
电影文学	影视文学
文书制度	文书工作制度
地方戏剧	地方剧
雹	冰雹
散装货物运输	散货运输
放弃权力	弃权
社会主义教育活动	社会主义教育运动
核化生防护	核生化防护
武器效应试验	武器试验
植保植检	植物检疫
未利用土地	未利用地
军事决算	国防决算
中国作家协会代表大会	作代会
海上情况处置	海情处置
国家公证	公证
林火	森林火灾
慰劳	慰问
水工程	水利工程
洲际导弹部队	战略导弹部队
武器装备生产定型	武器装备定型
边境居民	边民
大气紊流	大气湍流
导弹类装备	导弹装备
避震疏散	避震撤离
股市	股票市场
作战成果	战果
非赢利性团体	非营利性团体
卫生机构	医药卫生机构
边境纠纷	边界争端
质量控制	质量管理
族游点	旅游景点
冰挂	雨凇
测雨雷达	气象雷达
霜降	二十四节气
涉外	涉外事务
零售价格	零售价
资本审核	验资
精简编制	精简整编
重型设备	大型设备
保健品	保健食品
军队编制序列	军队序列
原子武器防护	核武器防护
服装配件	服装饰品
污染物环境标准	排放标准
地区性战争	局部战争
二次虹	霓
信件办理	办信
作战指挥自动化	指挥自动化
人才合理流动	人才流动
公债	国债
贸易合约	贸易合同
犯法	违法行为
江河地区防御战役	防御战役
减轻负担	减负
兵役制	兵役制度
武装占领	军事占领
台独	台独问题
行政记过	记过
骨干项目工程	骨干工程
农林特产税	农业特产税
市话	市内电话
保费	保险费
作战损耗	作战消耗
反腐败	反腐败斗争
航空部队通信	航空兵通信
形势任务教育	形势教育
工业配置	工业布局
托管	委托管理
气象预报	天气预报
露营训练	野营训练
防卫政策	国防政策
执法工作	执法
牧业	畜牧业
矿业	采矿业
核心要素数字线划地图数据库	地图数据库
军事科研课题	军事科研项目
军事教育影片	军教影片
邮件安全检查	邮检
干部质量	干部素质
武器装备展览	装备展览
导弹兵通信	导弹部队通信
宇航业	航天工业
全国人民代表大会常务委员会委员	全国人大常委
科学技术动员	科技动员
直燃式空调	燃气空调
渔业资源保护	水产资源保护
农副产品贸易	农贸
经济体制改革委员会	体改委
民企	民营企业
政治纪律	政纪
流动展览	巡回展览
直接电子对抗侦察	电子对抗支援侦察
无线电电子斗争	电子对抗
露点温度	露点
讲演	演说
技术研究	科研
轻兵器	轻武器
荣誉勋章	勋章
常务委员会委员	常务委员
城市高速道	城市高速公路
机要机构	机要部门
诈骗犯罪	诈骗
军地两用人才	两用人才
雹子	冰雹
情报语言	检索语言
军事科学研究工作	军事科研
城市热岛效应	热岛效应
国家动员体制	动员体制
邮件总包	总包邮件
警报信号	警报
粮食储藏	粮食储备
杂志	期刊
车队总员额	军队总人数
计算机工业	电子计算机工业
违反纪律	违纪行为
现地指挥	现场指挥
中继	中继方式
清除六害	打击犯罪
考察	视察
军品储备	军用物资储备
国际经济合作组织	国际经济组织
航运	水路运输
造船业	船舶工业
物流	物资流通
物资需要	物资需求
领馆	领事馆
资金信托计估	资信评估
皮革毛皮制品业	皮革工业
捐税	税收
电视传输网	传输网
搬运机械	装卸机械
企业精神	企业文化
卧铺客车	客车
账本	账簿
归国华侨联合会	侨联
信息检索	检索
中共中央纪律检查委员会全体会议	中央纪委全会
对外广播	国际广播
有意干扰	电子干扰
拳头产品	名牌产品
微生物工程	发酵工程
工业技术标准	工业标准
经济赔偿	赔偿
制帽业	鞋帽工业
防务政策	国防政策
作战成绩	战绩
容积	容量
水华	赤潮
暴雪	雪暴
运输价	运输价格
党的对外联络工作	党的外联工作
驾机投诚	驾机起义
外事	外事工作
军队纪律	军纪
航空模型	航模
军事科研部门	军事科研机构
竹简	竹木简
保额	保险金额
跨线桥	立交桥
军事司法工作	军事司法
移动式地球站	车载地球站
人工控制天气	人工影响天气
林彪反革命集团	林彪反党集团
科学知识	科技知识
海岸带	海岸
行政机构	行政部门
巡逻勤务	巡逻
水产	水产品
传真通信业务	传真业务
碧空	晴天
无产阶级专政	人民民主专政
战备程度	战备状态
海外贸易	对外贸易
火箭兵部队通信	导弹部队通信
交通用地	交通运输用地
体育道德	体育伦理
四化	四个现代化
民兵军事训练	民兵训练
林木采伐	采伐
轻工	轻工业
文教体育用品制造业	文体用品工业
来访	访问
地对地战略导弹部队	战略导弹部队
中国共产党第十一届中央委员会第三次全体会议	党的十一届三中全会
准静止锋	静止锋
舶船翻沉事故	沉船事故
公汽	公共汽车
国联	国际联盟
违反政纪	违反政治纪律
舰船叛逃	舰船外逃
江河水网地区防御战役	防御战役
检察人员	检察员
暴力性案件	暴力事件
装备现代化	武器装备现代化
脉码调制多路复用设备	数字复用设备
传送	传输
人员疏散	人口疏散
电信交换	通信交换
极地气团入侵	寒潮
ISM规则	国际安全管理规则
中国人民政治协商会议全国委员会主席办公会	全国政协主席办公会议
船舶翻沉事故	沉船事故
定区征集	定向征集
蜂业	养蜂业
战场工程准备	战场工程建设
自治县人民法院	基层人民法院
赋税	税种
勤务部署	执勤部署
田赋	农业税
汽车制造业	汽车工业
第三产业增加值	非农业人口
文件清点	保密检查
划区域征集	划区征集
大陆棚	大陆架
军兵种装备储备	军兵种储备
科技档案管理学	档案管理学
部队储备	军队储备
电信设备	通信设备
国际复兴开发银行	世界银行
社会生产	生产
国际奥林匹克委员会	国际奥委会
定购	订购
分组交换节点机	分组交换机
战争经济	国防经济
专用列车	专列
邮运费率	邮政运输费率
旧约	圣经
战争动员体制	动员体制
三废	废物
商业界	商界
地方性疾病	地方病
游民	牧民
搜寻救助	搜救
农村集市贸易	集市贸易
武装追捕勤务	武装追捕
澳门特区	澳门特别行政区
工业污水	工业废水
铃记	印信
少数民族医药学	民族医药学
劳动生产率	生产率
第一审案件	一审案件
国防动员	战争动员
宇宙观	世界观
耶稣教	新教
播音用语	广播电视用语
国防总动员	总动员
滥伐	乱砍滥伐
东风波	东风带波动
武装干预	武装干涉
军官退役安置	退役安置
医疗失误	医疗差错
降落	着陆
国资	国有资产
第三世界	发展中国家
乱收费乱摊派乱罚款	三乱
可利用性	可用性
乘警(铁路)	铁路警察
护理人员	护士
掠夺性战争	侵略战争
航天站	空间站
台湾独立问题	台独问题
卫生法制	卫生法规
技术进口	技术引进
台湾回归祖国问题	和平统一问题
国际联合会	国际联盟
空中交通管制建设	空管建设
安慰	抚恤
消毒用品	消毒剂
中央纪律检查委员会委员	中纪委委员
航天员	航天飞行员
舰艇探测	舰船探测
赠送	赠予
技术交易	技术贸易
边境地区民兵	边防民兵
军事援助协定	军援协定
村队企业	乡镇企业
拼音字母	汉语拼音字母
扶持贫困地区	扶贫
移用	挪用
军事使团	军事代表团
计算机软件	软件
送变电	输变电
古气候	地质时期气候
武器装备发展计划	武器装备发展规划
货运船	货船
军队体育工作队	体工队
军事当局	军事机关
兵学	军事科学
中央书记处办公会议	书记处会议
马克思列宁主义军事理论	马列主义军事理论
放火案件	放火案
普及法律常识教育	普法教育
政治体制	政治制度
古汉语	古代汉语
邪教	邪教组织
中央军事委员会主席	军委主席
工商协作	工商关系
中共中央工作会议	中央工作会议
中国人民政治协商会议全国委员会主席会议	全国政协主席会议
住宅	住房
店铺	商店
开埠通商	通商口岸
战略通讯	战略通信
气象火箭探空	气象火箭探测
清除出党	开除党籍
养鱼	鱼类养殖
副食品加工	副食品生产
排灌设备	排灌机械
地方人代会	地方人大
商品购买能力	商品购买力
病人教育	卫生教育
原子能工业	核工业
监察机构	监察部门
移文清册	交接文据
地图编制	地图编绘
武器装备科研课题	武器装备科研项目
歌谣	民歌
股东权益	所有者权益
发电厂	电厂
军事历史研究	军事史研究
政体	政治制度
出资方	股东
权	权力
社保	社会保障
林彪反革命事件	“九—三”事件
消费水准	消费水平
工艺品	工艺美术品
国防科学技术	国防科技
超编干部	编外干部
养蜂	蜜蜂饲养
作物	农作物
前景	发展趋势
港澳台合作经营企业	港澳台商企业
电脑	计算机
整顿经济秩序	经济秩序整顿
扭亏	扭亏增盈
工作责任制度	责任制
在建工程	基建工程
中国文学艺术界联合会代表大会	文化会	文代会
针灸	针灸疗法
汉语自动分词	汉语分词
专门物资	专用物资
登月	月球探测
物流设施	物流设备
副虹	霓
并购	资产重组
三产	第三产业
经济体改	经济体制改革
解密(文件)	解除密级
反腐蚀	反腐倡廉
负责人	领导人
军用装备	军事装备
枪械类装备	枪械装备
龙眼	桂圆
计算机网	计算机网络
人才优势	人才战略
军队后勤保障	后勤保障
装备订购	装备订货
养路	道路养护
专业技术干部	科技下部	科技干部
外贸	对外贸易
复交	恢复外交关系
假错案	冤假错案
配方食品	食品
凤梨	菠萝
降雨量	降水量
军营歌曲	部队歌曲
蚕业	蚕桑业
工贸	工商贸易
因公出境	因公出国
三防	核生化防护
安全理事会	安理会
勘查	勘察
转支	转移支付
国会制	议会制
灭菌	消毒
内河运输保卫	水运保卫
林产副业	林产品加工业
第二审案件	二审案件
家具工业	家具制造业
家畜饲养业	牲畜饲养业
商品检查	商品检验
空中运输	航空运输
视度	能见度
货币汇价	汇率
增加收入	增收
有限战争	局部战争
祖国统一	祖国统一问题
麻醉药品	麻醉剂
滩涂	滩涂地
绿地率	绿地覆盖率
国家总动员	总动员
惩治犯罪	打击犯罪
建筑材料工业	建材工业
煤炭	煤
物资储备平衔	物资平衡
林业区	林区
邮运	邮政运输
法(法律)	法律
主题词	叙词
延长预备党员预备期	延长预备期
国家干预	国家调节
工行	中国工商银行
汽车运动	赛车运动
邮封	邮资信封
告示	布告
水运	水路运输
纪检	安插亲信
大气分层	大气层
行政降职	降职
科研单位	科研机构
航测	航空测量
超市	超级市场
副热带高压	副热带反气旋
进步战争	革命战争
卫星地面站	地球站
黑毛风	沙尘暴
人类生物气象学	医疗气象学
汇集	汇编
船	船舶
气压	大气压
整风	作风整顿
编辑	编辑工作
商品流通行业	商品流通业
中外合作经营企业	合作企业
通过税	过境税
欧洲联盟	欧盟
经济委员会	经委
训练纲目	训练大纲
保荐	推荐
非盈利性团体	非营利性团体
处置突发事件	突发事件处置
国防经费	国防费
工作方式	工作方法
制造工业	工业
政纪处分	行政处分
预留	储备
剧院	剧场
治安拘留	拘留
营运费	运行费
山川旅游	山水旅游
租税	税收
仓库租金	仓库
气象情报传输	气象信息传输
电传业	电信服务业
气象观测站	气象站
训练纲要	训练大纲
防核武器	核武器防护
聘任制度	聘任制
家电	家用电器
国家债务	国债
艺术家	艺术欣赏
公共广播电视	电视广播
企业经营形式	企业经营
合资经营企业	合资企业
节约用水产业	节水产业
光电电子战侦察	光电对抗侦察
无产阶级政党	工人阶级政党
家族美德建设	家庭美德建设
大额特种存单	大额存单
交际舞	交谊舞
缩减军备	裁军
野营拉练	野营训练
劳模	劳动模范
公安干警	公安民警
税务	税务工作
反恐怖行动	反恐怖活动
人民防空工程	人防工程
全宗介绍	全宗指南
妇联工作	妇女工作
药物评价	药品评价
消毒药	消毒剂
武器置办	武器装备采购
军地互涉案件	互涉案件
电子反制	电子干扰
防务预算	国防预算
来往文书	来往文件
地方戏	地方剧
思考电影	思想电影
会议保密事项	会议保密
目录编排	编目
金融审计科	审计科
名牌	名牌产品
电视电话	可视电话
水花	赤潮
判处死刑	死刑
遵纪爱民	拥政爱民
社团	社会团体
人保	人身保险
国家空中交通管制委员会	国家空管委
军人义务教育	军人职责教育
军品出口贸易法规	军品出口法规
处置突发事件时间	处突时间
军队国有资产	军产
铁路客车	旅客列车
戒备等级	战备等级
百花齐放，百家争鸣	双百方针
科教兴市	科教兴国战略
关防	印信
滩地	滩涂地
中国文学艺术界联合会	文联
审计机关	审计机构
港商投资企业	港澳台商企业
司机	驾驶员
购买军火	武器装备采购
热力学性质	热特性
土地买卖	土地交易
对台贸易	两岸贸易
收容所	救助管理站
石油加工业	石油化学工业
电台新闻	广播新闻
中国人民政治协商会议全国委员会会议	全国政协会议
外交官员	外交官
艺术模特	人体模特
补助金	补助费
国民生产总值	国民经济总产值
贺辞	贺词
部队后方勤务	部队后勤
后备役	预备役
武警部队后勤	武警后勤
伯尔尼保护文学艺术作品公约	伯尔尼公约
军队装备	军事装备
装备规划、体制、类型	武器
科学研究	科研
整党整风	党的作风整顿
新药审批	药物批准
雷达电子战侦察	雷达对抗侦察
台军	台湾军队
内战	国内战争
两个文明建设	三个文明建设
武器装备转让	武器转让
气压形势	天气形势
外商独资经营企业	外商企业
世界贸易	国际贸易
哑语	手语
人选	三反运动
侨胞	华侨
警卫勤务	警卫
铁道	铁路
违犯纪律	违纪行为
军工生产转民品生产	军转民
舰船战斗航海勤务	舰艇战斗航海勤务
东南亚联盟	东盟
信息对抗	信息战
毒素武器	生物武器
台独运动	台独活动
增值型国防	增殖型国防
国际民用航空组织	国际民航组织
遴选	选拔
行政报告	工作报告
天气灾害	气象灾害
集购	集团购买
文物展出	文物陈列
武器装备采购费	装备购置费
欧洲经济共同体	欧共体
飞机场	机场
惩腐倡廉	反腐倡廉
严打	严打整治斗争
引进人才	人才引进
国家军力	军事实力
国营企业	国有企业
军工产品贸易	军品贸易
历史时期气候	历史气候
品牌优势	名牌优势
国防教育部门	国防教育机构
震后救灾	防震减灾
农用薄膜	农膜
虹	主虹
体改	体制改革
中医	中国医药学
城市绿地率	城市绿地覆盖率
财政补助	财政补贴
购买武器	武器装备采购
部件	零部件
妇女代表大会	妇代会
高科技产业	高新技术产业
英特网	因特网
监督改造	监督劳动
兵种	军兵种
电瓶	蓄电池
工作大纲	工作计划
农产品初加工机械	农产品加工机械
跟单付款	付款交单
林	森林
挂历	年历
整顿党风	党的作风整顿
后备役训练	预备役训练
水保措施	水土保持措施
特种地图	专题地图
维护社会稳定	维稳
沼泽	沼泽地
裁军会议	裁军谈判
消极干扰	无源电子干扰
盐业	制盐工业
民进	中国民主促进会
社会总产值	国民经济总产值
节水型农业	节水农业
航天遥感测绘	遥感测绘
农产品初加工业	农产品加工业
独立战争	民族解放战争
光学纤维	光纤
科学技术进步奖	科技进步奖
战争动员机构	动员机构
跨国集团	跨国公司
中继路由	路由
条码	条形码
联合国粮食及农业组织	联合国粮农组织
木简	竹木简
应征对象	应征公民
淡水捕捞业	内陆捕捞业
军队驻地警卫	军营警卫
妇女联合会	妇联
迎宾部队	仪仗队
农业副产品	农副产品
部队武器装备	部队装备
出售	销售
中共中央扩大工作会议(1962)	七千人大会(1962)
诬告	诬陷
礼物	礼品
呈	呈文
导弹核战争	核战争
防化类装备	防化装备
出国参观	出国考察
内网	内部网
军委纪律检查委员会	军队纪律检查委员会
筹集资金	集资
财务收支审计	财务审计
则政工作人员	财政人员
黑风	沙尘暴
全国人民代表大会常务委员会委员长办公会议	委员长办公会议
凭照	凭证
武器贮备	武器装备储备
文职管员	文职干部
专门地图	专题地图
文献解密	解除密级
萨斯	非典
常委委员	常务委员
会议记录	会议录
微电脑	微型计算机
辞典	词典
数字艺术	电子艺术
反光电干扰	光电反干扰
赤道无风带	热带辐合带
民兵装备	民兵武器装备
党中央	中共中央
举报	检举
学雷锋	学雷锋活动
正规部队	正规军
航天通信	空间通信
婚前体检	婚前检查
床位数	病床数
从严治警	依法治警
步兵武器	轻武器
捐献器官	器官捐献
军事冲突	武装冲突
低温冷害	冷害
政协权国委员会	全国政协
国家关系正常化	恢复外交关系
救捞	救助打捞
战区自动化指挥系统	战区指挥自动化系统
医风	医德
刊物	期刊
稿子	草稿
除六害	打击犯罪
起诉状	起诉书
土地	耕地保护
简	简牍档案
迷信活动	封建迷信活动
联合国安全理事会	安理会
反恐怖斗争	反恐怖活动
个体工商业	个体户
国防思想	国防理论
网路标准	网络标准
冷冻设备	冷冻冷藏设备
澳大利亚元	澳元
乙型肝炎	乙肝
战斗机	歼击机
石化工业	石油化学工业
政工机构	政工部门
地对空导弹	地空导弹
粮油买卖	粮油销售
政局	政治局势
比赛器械	运动器械
弱震	有感地震
优化设计	最优设计
财务会计	会计
干燥区	旱区
多角贸易	多边贸易
服装制造业	服装工业
出国访问	出访
交税	纳税
反对核武器运动	反核运动
武器装备验收	装备验收
医案	病案
毁林	乱砍滥伐
军营绿化	营区绿化
侨属	侨眷
合议制	合议庭制度
微波接力通信	微波中继通信
引渡	罪犯引渡
军事港口	军港
化学肥料	化肥
档案解密	解除密级
敌我兵力对比	兵力对比
税收种类	税种
通讯卫星	通信卫星
通信电子战侦察	通信对抗侦察
军事管制委员全	军管委员会
军队报刊	军队期刊
城市居民点用地	出让土地
电子地图	数字地图
广播电视	电视广播
风暴海啸	海啸
家教	家庭教育
资料解密	解除密级
节目	节假日
商业中心	商业网点
爱国卫生委员会	全国爱卫会
BB机	无线寻呼机
龙吸水	水龙卷
反电子措施	电子干扰
侦察通信联络	侦察通信
万国邮政公约	万国邮政日
迎外部队	仪仗队
保密条例	保密规定
食品加工业	食品工业
军校	军队院校
扫黄	扫黄打非
武器装备禁运	武器禁运
心战	心理战	政治渗透
文物研究	考古研究
党代表会议	党代表大会
武器装备分级管理	装备分级管理
江盗	盗窃船运物资
军队建制	军队体制
原子战争	核战争
军纪委	军队纪律检查委员会
电子战情报侦察	电子对抗情报侦察
战术自动化指挥系统	战术指挥自动化系统
武器装备维修	装备维修
社教	社会主义教育
人民防空通信	人防通信
违纪	违纪行为
文革	文化大革命
个人所有制企业	个体企业
台资企业	台商企业
销路	销售渠道
违法狩猎	非法狩猎
中共中央纪律检查委员会常务委员会会议	中央纪委常委会议
三金工程	金字工程
海上航行计划	航海计划
军用转民用	军转民
冻雨	雨凇
中国人民政治协商会议	政协会议	政协
安全设备	安全防护设备
陆架	大陆架
后方勤务保障	后勤保障
医疗设备	医疗器械
投资者	投资人
水上体操	花样游泳
炒汇	外汇交易
效费比	费效比
军事人犯	军事罪犯
反恐怖	反恐怖活动
森林副产品	林业副产品
合约	合同
军备限制	军备控制
看押勤务	看押看守勤务
大气	地球大气
个人电脑	微型计算机
金属制品业	金属制品工业
法定代表人	法人
报刊收订工作	报刊征订
人为干扰	电子干扰
任免权限	任免权
生活资料	消费资料
军工产品产量	军品产量
人防工事	人防工作
两面间谍	双重间谍
货盗	盗窃运输货物
军事干预	武装干涉
岗贴	岗位津贴
驻地警卫	军营警卫
军品贸易法规	军贸法规
直接调拨	直拨
科教兴工	科教兴国战略
反政府斗争	反政府活动
著作权	版权
时梅雨	梅雨
宗教节	宗教节日
舰船工业	船舶工业
制鞋业	鞋帽工业
会计账本	会计账簿
停止战争	停战
舰船导航	舰艇导航
咨询服务	咨询
科学研究机构	科研机构
馈赠	增予
档案提供利用	档案利用
响雨	冰雹
劳保	劳动保护
休干所	干休所
技术进步	科技进步
税收行为人	纳税人
伤残人士	伤残人员
高压脊	高压楔
集团军医院	野战医院
文选	文集
时间限制	时限
企图	意图
断绝外交关系	断交
电磁对抗	电子对抗
境外旅游	出境游
热屏蔽	隔热
军事航海、航空、航天	飞行表演
军队指挥理论	指挥理论
联合指挥部	联合指挥所
火线	前线
装备费审计	装备审计
零担运输	零担货物运输
价格结构	价格构成
性传播疾病	性病
伪钞	假钞
收监	收监执行
民族贸易	民族商业
国际互联网	因特网
备战	战备工作
智力竞赛	知识竞赛
抢救遇难群众	抢救遇险群众
军队文艺工作团体	文工团
税务人	税务人员
研究会	研讨会
军工产品出口	军品出口
培养军地两用人才	两用人才培养
保密文电	机密文电
少数民族干部	民族干部
报刊征订工作	报刊征订
个体	个体户
大学	高等院校
非典型性肺炎	非典
邮政信箱	邮政信筒
国共和谈	国共谈判
药物注册	药品注册
作战运筹研究	军事运筹学
生命保障系统	生保系统
优生	优生优育
出厂价格	出厂价
汇费	汇兑资费
广播系列报道	广播连续报道
害虫防治	病虫害防治
国际规范	国际标准
财政审计	财政收支审计
黄埔同学会	黄埔军校同学会
领海界限	领海线
代理职务	代职
土地争议	土地纠纷
四个坚持	四项基本原则
宇航技术	航天技术
通讯	通信
战舰	军用舰船
军事著述	军事著作
电子对抗措施	电子干扰
行政主管部门	行政管理部门
商业人员	商人
体育经纪机构	体育经纪人
投资效果	投资效益
海上民兵	海防民兵
商品采购	商品购买
技术引进	技术引进
原理	理论
广播黑白电视	电视广播
水上运输保险	水险
歪风邪气	不正之风
科学技术会议	科技会议
军体	军事体育
武器工业	兵器工业
非正规军	地方部队
办学方向	办学方针
甲型肝炎	甲肝
冥器	明器
公路运输	挂车
共青团代表大会	团代会
长江三峡	三峡
副反应	药物不良反应
裁减军备谈判	裁军谈判
挂号邮件	给据邮件
武器装备预研课题	武器装备科研项目
地产纠纷	土地纠纷
引得	索引
全国人民代表大会常务委员会	全国人大常委会
流域专业规划	流域规划
统一收购	统购
安插私人	安插亲信
牲畜	家畜
雾凇	凇冰
海水淡化	海水淡化利用
建筑工业	建筑业
临场指挥	现场指挥
黄色出版物	淫秽出版物
战争占领	军事占领
集约式经营	集约经营
驱逐外国渔船	驱赶外国渔船
家庭保姆	保姆
军衔制	军衔制度
国家军事实力	军事实力
深水航道	航道
边防晤谈	边防会谈
澳门地区	澳门特别行政区
电讯保密	通信保密	通讯保密
军车	军用车辆
潜水艇	潜艇
国内债务	内债
赢利	盈利
党的纪律	党纪
海峡两岸关系	两岸关系
科学进步	科技进步
主管机构	主管部门
小水电	小水电站
统战	统一战线
基本建设项目	基建项目
每月报表	月报
巨大损失	重大损失
工业贸易结合	工贸结合
交换系统	通信交换系统
工厂搬迁	工业疏散
削减军备	裁军
保障系统	支援系统
一级财政	中央财政
海上运输保险	海上保险
国土	国有土地
节假日旅游	假日旅游
空中测量	航空测量
大哥大	移动式手持机
空间飞行器	航天器
大气乱流	大气湍流
医用废弃物处理	医疗废弃物处理
指挥控制通信情报系统	C31系统
区域划分	区划
人民警察	民警
战地宣传	阵地宣传
手机	移动电话机
电影脚本	电影剧本
重型武器	重武器
军事训练大纲	训练大纲
军事援助顾问团	军事顾问团
连续时间	持续时间
供需关系	供求关系
香港特区	香港特别行政区
世贸组织	世界贸易组织
节日活动	节假日活动
商品流通产业	商品流通业
还贷款	还贷
定密度气球	定高气球
贿赂罪	行贿罪
树挂	凇冰
党的章程	党章
气象卫星探空	气象卫星探测
军火采购	武器装备采购
战备、训练	三防训练
开放搞活	对外开放
股份合作企业	股份制企业
电子反干扰	反电子干扰
通令缉拿	通缉
桑蚕业	蚕桑业
药材作物	药用作物
化学纤维制造业	化学纤维工业
违法捕捞	非法捕捞
电磁战	电子对抗
申请表	申请书
供销单位	供销部门
雪害	雪灾
军事条例	军队条例
平定叛乱	平叛
座谈会纪要	会议纪要
全国人民代表大会	全国人代会	全国人大
军队文职干部	文职干部
自首	投案自首
技术贸易	技术市场
技术合作	科技合作
严打斗争	严打整治斗争
免于起诉	免诉
戈壁地区防御战役	防御战役
商品包装	产品包装
纪律检查	纪检
保密时限	保密期限
军事教育片	军教影片
军事科研单位	军事科研机构
审计结果报告	审计报告
观测天体定位	天文定性	天文定位
军官素质	军人素质
装备科研、技术基础	威力试验
军队政治工作研究	军队政工研究
水电站	水力发电站
后勤组织指挥	后勤指挥
外核	外部审计
一个国家两种制度	一国两制方针
戏曲	戏剧
工程用车	工程车
执业药师	药剂师
气候灾害	气象灾害
侦查员	侦查人员
抵偿贸易	补偿贸易
哲学学说	哲学理论
空军专用装备	空军装备
烟叶	烟草
航天发射市场	航天发射市场
法治	依法治理
共犯	同案犯
合作经济	集体经济
制黄贩黄	制售淫秽物品
电信业	电信服务业
三废综合利用	废物综合利用
卫生勤务保障	卫勤保障
干部晋升	干部任免
计算机互联网	互联网
谈话纪要	谈话记录
化生放防护训练	三防训练
庆祝大会	庆祝会
商业贸易审计	商贸审计
来信来访	信访
烤烟叶	烤烟
世行	世界银行
经济软着陆	软着陆
军事学	军事科学
陈列	陈列工作
军事动员	武装力量动员
中央书记处会议	书记处会议
黑风暴	沙尘暴
对投诚人员政策	对起义人员政策
三军联勤	联勤
空运	航空运输
贮备	储备
村民委员会	村委会
冶金机械	冶金设备
单耗	单位消耗
建材	建筑材料
人工增雨	人工降水
财经	财会经济
专利权	专利
飞行管制	空中管制
境外游	出境游
霉雨	梅雨
食品保藏	食品保存
飞机型号	机型
新时期建军总要求	军队建设总要求
纺织产品	纺织品
武装力量史	军史
停止战斗	停战
国际公法	国际法
一点多址微波设备	微波通信设备
人大常务委员全	人大常委会
管理方法	管理办法
食油	食用油
光电对抗干扰	光电干扰
铸造设备	铸造机械
试通航	试航
无法投递邮件	无着邮件
非核有限战争	局部战争
工业尘	工业粉尘
工业枢纽	工业中心
温度场	温度分布
侵略行为	侵略
土特产	土特产品
羽绒制品业	羽绒工业
通讯保密	通信保密
货运	货物运输
空气密度	大气密度
核战争战略	核战略
农副产品加工业	农产品加工业
军用港口	军港
美术品	艺术作品
洲际导弹	洲际弹道导弹
欧洲共同体	欧共体
第二世界	发达国家
领海界线	领海线
社区	街道办事处
五句话总要求	军队建设总要求
刑罚种类	刑种
裁谈会	裁军谈判
人民防空袭通信	人防通信
清理档案	档案清理
舰艇编队	海上编队
初步裁决	初裁
时雨	梅雨
国防后勤	军事后勤
大客车	大轿车
合营	合作经营
电报密码	电报代码
武装押送	武装押解
城镇人口	非农业人口
防原子	核武器防护
主题标引工作	主题标引
非核战争	常规战争
商标专用权	商标权
臭气层破坏	臭氧层破坏
军队后勤指挥	后勤指挥
大地测量卫星	测地卫星
军队体育工作团体	体工队
资讯服务	信息服务
治理淮河	治淮
台盟	台湾民主自治同盟
军衔等级制	军衔制度
自卫战争	反侵略战争
电子产业	电子工业
殡葬	丧葬
光电抗干扰	光电反干扰
储蓄存款	储蓄
刑事处罚	刑罚
科学技术潜力	科技潜力
输电网	电网
人民防空演习	人防演习
积压物	积压物资
回教	伊斯兰教
人民防空工作	人防工作
商业津贴	商业补贴
基层党组织	党的基层组织
电话通信	电话
查封	清查
数字多路复用设备	数字复用设备
上市企业	上市公司
出境旅游	出境游
职务调整	调职
最后裁定	最终裁定
臭氧空洞	臭氧层空洞
总统选举	大选
严重警告处分	严重警告
金库	国库
文书处理	文件处理	公文处理
幼儿教育	学前教育
计息日期	计息期
荒漠草原地区进攻战役	进攻战役
区人民法院	基层人民法院
价格组成	价格构成
账册	账簿
以权制权	监督制衡
巡视	视察
投诚人员	起义投诚人员
武器擦拭	武器保养
部队文艺	军队文艺
周边游	边境旅游
会议参考资料	会议资料
电信干线	通信干线
战争史	战史
联合办案	合作办案
反干扰	反电子干扰
程度	度
学生军事训练	学生军训
科学技术	科技
科学技术政策	科技政策
中国人民解放军院校	军队院校
三联供	三联技术
国防动员体制	动员体制
军力	兵力
价值法则	价值规律
写本	抄本
放火	纵火
偷听器	窃听器
军事援助协议	军援协定
直播卫星业务	广播卫星业务
港澳台商投资企业	港澳台商企业
取样	采样
海军专用装备	海军装备
食品制造业	食品工业
寒潮天气	寒湖
防生物战	生物武器防护
制造业	工业
火箭核战略	核战略
痕检	迹检
盗伐	盗伐林木
洪涝灾害	水灾
大气压强	大气压
企业经营机制	企业经营
水上芭蕾	花样游泳
舰船出访	舰队出访
对外投资	国际投资
经济法则	经济规律
贸易契约	贸易合同
网路技术	网络技术
党的作风建设	党风建设
集体所有制企业	集体企业
政治审查	政审
倒卖船票	倒票
电视宣传	影视宣传
空间技术应用	航天技术应用
商业区	商业网点
外国军队	外军
进梅	入梅
澡堂	淋沐设施
列检	列车检查
个人工商户存款	个人存款
雷场探测	探雷
患者	病人
军功奖章	军功章
外联工作	党的外联工作
主题地图	专题地图
热带风暴	台风
防细菌	生物武器防护
单人业主制企业	个体企业
粮食预留	粮食储备
防化学	化学武器防护
调资	工资调整
政协全国委员全常务委员	政协常务委员
外交代表	外交使节
乡村邮路	农村邮路
包换机	分组交换机
平均税率	税率
核查	核查工作
中央工作会议	中共中央工作会议
航空管制建设	空管建设
停止执行职务	停职
雷达对抗措施	雷达干扰
野战供水	野战给水
阿拉伯国家联盟	阿拉伯联盟
调查研究	调研
事件(公安)	事件
总部装备储备	总部储备
粗放式经营	粗放经营
技术能力	技能
婚姻介绍服务	婚介服务
样机样品费	科研经费
总里程	里程
资产负债表审计	财务报表审计
军事邮政	军邮
港币	港元
供销关系	供求关系
非金属矿工业	非金属矿采选业
非处方药	OTC药
商号	商店
物业服务	物业管理
交接清册	交接文据
考察团	访问团
电报通信业务	电报业务
专属物资	专用物资
供需调节	供求关系
空间飞行器发射	航天器发射
BP机	无线寻呼机
信息加工	信息处理
中药材	中草药
燃气管线	燃气管道
清洁用车	清洁车
技术文档	技术文件
塑料制品业	塑料制品工业
民族志	民族史志
新药注册	药品注册
劳功改造	劳改
部队纪律教育	军纪教育
空军自动化指挥系统	空军指挥自动化系统
勘查开发	矿产勘查
周转费	运行费
大气条件下试验	环境试验
港台合作经营企业	港澳台商企业
交易磋商	贸易谈判
电视	电视广播
纠风	纠正不正之风
气象保障	气象服务
技术服务业	科技服务业
侨资企业	华侨投资企业
进出口税	关税
联勤工作	联勤
支谱	家谱
指挥控制通信计算机情报系统	C41系统
办公业务资源网	外网
收支两条线管理	两条线管理
边防哨卡	边防哨所
军事管制委员会	军管委员会
专门审计	专项审计
野营	野营训练
服饰	服装饰品
中国人民解放军建军节	八一建军节
海上运输保卫	海运保卫
产业优化升级	产业升级
物资综合平衡	物资平衡
其它费用	杂费
发展科学文化艺术方针	双百方针
旅游团	旅游团队
中央领导同志	党和国家领导人
降雪量	降水量
台属	台眷
核爆炸试验	核试验
会议参考资例	会议资料
对外开放政策	开放政策
军需品储备	军用物资储备
节日口号	节假日口号
坦克装甲类装备	装甲装备
空降兵部队通信	空降兵通信
经济效果	经济效益
调动兵力	部队调动
体格检查	体检
修船厂	船厂
海军自动化指挥系统	海军指挥自动化系统
灌溉设备	灌溉机械
饮水	饮用水
装甲类装备	装甲装备
救火车	消防车
西医教育	医学教育
退休金	退休费
诊所	医院
军队歌曲	部队歌曲
三通	两岸三通
农业人口	农村人口
对潜艇通信	对潜通信
八六三计划	863计划
国防后备力民建设	后备力量建设
技术贸易结合	技贸结合
警用装备	武警装备
核防护	核武器防护
人防演练	人防演习
旅客运输	客运
光学对抗干扰	光电干扰
后勤保障现代化	后勤现代化
后方勤务部署	后勤部署
艺术品	艺术作品
技术档案	科技档案
退役	退伍
战争动员法规	动员法规
海上运输	海运
台风槽	台风低槽
人造卫星定型	卫星定型
大气臭氧层	臭氧层
违法	违法行为
优化资本结构	资本结构优化
军民纠纷	军地纠纷
联运	联合运输
电子斗争	电子对抗
战备演练	战备演习
作战硕案	作战方案
航母	航空母舰
军事审判院	军事法庭
药房	药剂科
国际共运	国际共产主义运动
十二金工程	金字工程
警卫员	警卫人员
常规兵器	常规武器
农产品初加工服务业	农产品加工服务业
特种器械	医疗器械
宗谱	家谱
沿海	沿海地区
回归祖国问题	和平统一问题
药品副作用	药物不良反应
支援国家经济建设	支援国家建设
卫勤组织战术	卫生勤务
亚洲体育运动会	亚运会
政治工作部门	政工部门
军民联合防卫	军民联防
核防护气象保障	核武器防护
对外外联络工作	外联工作
组织机构	机构
建立外交关系	建交
尖端武器	高技术武器
接力站	中继站
多国公司	跨国公司
解除行政处分	撤销行政处分
甄别	甄别工作
技术规范	技术标准
军运	军事运输
淡水养殖业	内陆养殖业
被告人	被告
美展	美术展
常务委员会	常委会
月球旅行	月球探测
天气局	气象局
代理(法律)	法律代理
入霉	入梅
贮藏	储藏
军人纪律教育	军纪教育
炒股	股票交易
国防运输	军事运输
商检	商品检验
血站	血库
台湾独立	台独问题
刑讯	刑讯逼供
洪灾	水灾
废弃装备	报废装备
运输费	运费
原告人	原告
竹材采运业	林木采运业
印染业	印染工业
押犯	武装押解
中行	中国银行
公款	公费
私人企业	私营企业
远洋渔业	海洋渔业
乱罚款	三乱
强台风	台风
军事科研、外事、保密工作	保密检查
滥发钱物	滥发奖金实物
统制贸易	对外贸易国家专营制
党委会	党委
港澳台商投资股份有限公司	港澳台商企业
装备订货、军援军贸	武器装备采购
人民来信来访工作	信访工作
科技市场	技术市场
赤道辐合带	热带辐合带
天气雷达	气象雷达
出资人	股东
科教兴国	科教兴国战略
民主人士	爱国人士
审计单位	审计机构
军营文化生活	部队文化生活
人才分流	人才流动
阴天	阴
军工产品进口	军品进口
民革	中国国民党革命委员会
督查	督查工作
体育比赛	体育竞赛
科技开发	技术开发
武器装备试验环境	武器装备试验
党的作风	党风
中学生军事训练	学生军训
社情动态	社会动态
扶贫帮困	扶贫
生态环境旅游	生态旅游
成品	产品
文艺工作团	文工团
空间技术	航天技术
测雨雷达站	天气雷达站
防空专业队伍	群众防空组织
电子战侦察	电子对抗侦察
武器研制	武器装备研制
军检	军代表检验
外交事务军官	外事军官
审计规定	审计标准
断梅	出梅
舰船越境	舰船越境
公文主题词表	公文叙词表
农民工	民工
判处	判决
西药学	药物学
红外云图	红外卫星云图
财政审计科	审计科
防护设备	安全防护设备
卫国战争	反侵略战争
医学支援	卫勤保障
高空天气站	高空气象站
少年军校训练	学生军训
制定	制订
老年	老年人
真迹传真	传真
新约	圣经
军事预算	国防预算
国际机构	国际组织
军务	军务工作
国家政治实力	政治实力
厅务会议	厅务会
边界联合检查	边界联检
农副产品加工	农产品加工
暴风雪	雪暴
军运设施	军事运输设施
学说	理论
工作安排	工作计划
地震灾害	震害
比赛	竞赛
干旱	旱灾
旅游区绿化	风景区绿化
空气质量	大气质量
中国共产党全国代表会议	党的全国代表会议
公务费	行政费
中草药种植业	药材种植业
飞机越界	飞机越境
商业补助	商业补贴
看守勤务	看押看守勤务
科教兴农	科技兴农
测量控制系统	测控系统
进攻作战	进攻
交换过程	交换
税金	税款
雨量	降水量
深空通信	空间通信
优育	优生优育
农业用地	农用地
复线	道路复线
中央顾问委员会	中顾委
裁减军备	裁军
军队刊物	军队期刊
作战准备	战备
城市基本建设档案	城建档案
武器装备试验条件	武器装备试验
国有	国家所有制
生产绿地	居住区绿化
采掘业	采矿业
劳务合同	劳动合同
俘虏问题	战俘问题
中央纪委	中纪委
军事交通、物资、基建营房勤务	军队仓库
天气系统	气压系统
可维护性	维修性
最佳设计	最优设计
军队营养	部队营养
不稳定性	稳定性
中央政治局常务委员会委员	中央政治局常委
生产总值	总产值
后勤理论	军事后勤理论
水产加工	水产品加工
硬赤字	财政赤字
大企业	大型企业
统一战线工作	统战工作
军事管制	军管
边防海防通信	边海防通信
中型企业	中小型企业
希伯来教	犹太教
野战自动化指挥系统	野战指挥自动化系统
商品住宅	商品住房
锋面	锋
中国象棋	象棋
军事干涉	武装干涉
对内贸易	国内贸易
档岸编号	档号
土地划分	土地规划
文体用品制造业	文体用品工业
非话电信业务	非话业务
兵员征集	征兵
特用经济林	经济林
涝灾	水灾
国民生产净值	国民生产净产值
大陆度	大陆度指数
国际共产主义运动	国际共运
航海标志	航标
政策银行	政策性银行
作战会	作战会议
兵制研究	军制研究
电报电码	电报代码
现代化后勤	后勤现代化
土地资产处置	土地资产处理
出国留学	留学
尖端技术	高新技术
摄像器材	摄像设备
近战武器	轻武器
湿润度	湿润指数
军械工业	兵器工业
土地使用费	土地征用费
证明书	证书
死刑缓期执行	死缓
文艺表演团体	文艺团体
法	法律
HIV感染	艾滋病
基因组计划	人类基因组计划
处置突发事件方案	处突方案
马列主义政党	马克思主义政党
电报通信网	电报网
中程制导	制导
植树造林	造林
战备道路	战备公路
生物防护	生物武器防护
后备役部队	预备役部队
档案主题词表	档案叙词表
音像	音像制品
微机	微型计算机
海上搜救	搜救
初级企业制度	传统企业制度
航海运输	海运
气象站网	气象台站网
医德医风	医德
气候形成因子	气候因子
体协	体育协会
三材	建筑材料
残废	残疾
卫星载试验	航天器载试验
全国人民代表大会常务委员会会议	全国人大常委会议
后勤工作现代化	后勤现代化
原子武器	核武器
无线电通信反干扰	通信反干扰
中央军事委员会	中央军委
全集	汇集
传染性疾病	传染病
海峡两岸关系协会	海协会
地质矿产业	采矿业
外包工程	出包工程
冷藏设备	冷冻冷藏设备
打击非法出版活动	打非
第三性界	发展中国家
支援农业	支农
入会费	会费
军事学术研究机构	军事科研机构
武器装备分配	装备分配
预算赤字	财政赤字
经济贸易委员会	经贸委
废品	废旧物资
国外贸易	对外贸易
维护稳定	维稳
晴	晴天
武装督察	武警
转换债	转换债券
外交	外交工作
统收	统收统支
工程建设计划	工程计划
牛奶加工机械	乳品加工机械
航班时刻	时刻表
国际铁路联营合同	列车
1989年春夏之文的政治风波	1989年政治风波
公文种类	文种
边境冲突	边界冲突
卫生支援	卫勤保障
武装押解勤务	武装押解
武器装备组织计划	装备组织计划
原油储备	石油储备
旅游产品	旅游服务产品
红皮书	白皮书
税后利润	利润
电子计算机制造业	计算机制造业
通航水道	航道
军事交通勤务	军交勤务
草地	牧草地
艺术馆	文化馆
监委	监察委员会
生产资料所有制	所有制
玩忽职守	渎职
营区环境卫生	环境卫生
验船	船舶检验
海洋潮汐	潮汐
旅游社	旅行社
断霉	出梅
航空器制造业	航空工业
刑事警察	刑警
设计	设置
提货单	提单
大学生军事训练	学生军训
落黄沙	浮尘
果园	果园地
武器装备采办	武器装备采购
撤消	撤销
去职	免职
市场制度	市场机制
马克思主义军事理论	马列主义军事理论
主要战斗装备体制	主战装备体制
联合经营	联营
治理黄河	治黄
清洁设备	卫生设备
市民	城市居民
税收制度	税制
延期费	滞期费
寒潮天气过程	寒湖
邮运计划	邮政运输计划
包谷	玉米
战争准备	战备
中国人民政治协商会议全国委员会主席办公会议	全国政协主席办公会议
电磁斗争	电子对抗
备战演习	战备演习
军民兼容	军民结合
军事科学研究部门	军事科研机构
空对空导弹	空空导弹
国防企业	军工企业
舰船来访	舰队来访
防务支出	国防支出
别字	错别字
普法	普法工作
图书展销	书展
国民收入	国民经济净产值
热带山岳丛林地区防御战役	防御战役
以进养出	来料加工
驻止野营训练	野营训练
秘密等级	密级
长远规划	长期规划
军队干部工作	干部工作
族谱	家谱
全国人民表大会常务委员会会议	全国人大常委会议
外国政府援助	外援
关贸总协定	世界贸易组织
药品生产企业	制药企业
服装加工机械	服装机械
人防专业队伍	群众防空组织
作风养成教育	养成教育
水上运输	水路运输
电信终端	电信终端设备
储藏量	储量
风雪流	雪暴
防务战略	国防战略
交通警察	交警
中国共产党第十—届中央委员会第三次全体会	党的十一届三中全会
风切变线	切变线
真迹传真机	传真机
军事训练工作	训练工作
火箭核战争	核战争
电子邮政	电子信箱
速度	速递业务
抚恤金	抚恤费
飞机播种造林	飞播造林
潜水艇探测	潜艇探测
书刊市场	出版市场
程序编制	软件开发
资产处置	资产处理
中国人民政治协商会议全国委员会常务委员会会议	全国政协常委会议
中外合资经营企业	合资企业
军队宗旨教育	建军宗旨教育
社会服务	社会化服务
价格监督	物价监督
科学技术档案	科技档案
不正当两性关系	生活作风问题
高气压	反气旋
设备入网	设备进网
地权	土地产权
评议行风	行风评议
运输数量	运输量
互相监督	十六字方针
党纪检查工作	纪检工作
节气	二十四节气
烟草加工业	烟草工业
空降部队通信	空降兵通信
则政储备	财政后备
航管建设	空管建设
运货	货物运输
干部轮训	干部培训
游览区	旅游区
材料(工业)	材料
文换关系	交换
物流储备	物资流通储备
领导人员	领导人
补交税款	补税
部队建设	军队建设
牧地	牧草地
下基层锻炼	下基层
党组织	党的组织
故意放火	纵火
服装佩饰	服装饰品
枢纽站	交通枢纽
职工代表大会	职代会
武装斗争	军事斗争
婚前保健	婚前检查
群众表扬信	表扬信
勘察设计	勘察
参阅文件	参考文件
番茄	西红柿
武警通信	武警部队通信
中共中央扩大的工作会议(1962)	七千人大会(1962)
烈士家属	烈属
技术信息	科技信息
地契	土地证
精神药物	精神药品
军顾团	军事顾问团
募捐义演	义演
财会工作	财务工作
技改项目	技术改造项目
断裂地震	构造地震
运输费用	运费
钢轨	铁轨
环卫	环境卫生
干旱区	旱区
军事教学影片	军教影片
防化学武器	化学武器防护
医政	医政管理
纺织	纺织工业
军事审判庭	军事法庭
预备役部队训练	预备役训练
常委委员会	常委会
军事科学技术	国防科技
武器装备研究	武器装备科研
拘禁	拘留
毒剂武器	化学武器
国家界限	国界
对外联络工作	外联工作
政治评论家	政论家
军队领导人	军队领导人员
雪量	降水量
外长	外交部长
狗	犬
仪器	仪器仪表
农话	农村电话
人民代表大会常务委员会	人大常委会议
侦察通联	侦察通信
军事援助	军援
电焊设备	焊接设备
版权	著作权
全国运动会	全运会
土地使用规划	土地利用规划
外经	对外经济贸易
部颁文件	部委文件
工业交通审计科	审计科
舰船越界	舰船越境
价格补贴	物价补贴
党委员会	党委
疆界	边界
行包	行李
人民防空指挥	人防指挥
文件	公文
仪表	仪器仪表
防生物武器	生物武器防护
联合国教育、科学及文化组织	联合国教科文组织
全国人代会	全国人大
火化	火葬
区域组织	区域性组织
长期共存	十六字方针
出国游	出国旅游
科学社会主义理论	科学社会主义
组织工作	领导班子建设
航天遥感数字正射影像数据库	地理信息数据库
灭菌剂	消毒剂
档案专业教育	档案教育
军事科研工作	军事科研
土地监查	土地监察
飞机事故	飞行事故
品德教育	德育
造纸业	造纸工业
中国共产党全国代表大会	党的全国代表大会
烟草制品业	烟草工业
军工产品结构	军品结构
图章	印章
工效结合	工效挂钩
国防网	国防通信网
敏感武器装备	敏感装备
药学教育	医学教育
软件开发业	软件业
军队后勤指挥自动化	后勤指挥自动化
逆用间谍	双重间谍
局部地区动员	局部动员
警种	警察种类
航空遥感测绘	遥感测绘
1989年春夏之交的政治风波	1989年政治风波
工程船舶	工程船
三通问题	两岸三通
城乡基建	城乡基础建设
偷渡	外逃
经贸	经济贸易
军官退役	干部退役
刺灸法	针灸疗法
邮政运输调度	邮运调度
电汇	电报汇款
供水设备	给水设备
人民代表大会	人代会	人大
国家行政机关	政府机关
户口	户籍
通信网络	通信网
邮筒	邮政信筒
消费引导	消费导向
地貌	地形
征地	土地征用
科教兴牧	科技兴牧
需要	需求
邮片	邮资明信片
国际标准舞	国标舞
外国军事研究	外军研究
平均数	平均指标
军区装备储备	军区储备
军事法令	军事法规
广播影视	广播电影电视
航空母舰编队	航母编队
保护耕地	耕地保护
外国轮船	外轮
腐化堕落	腐败
龙卷	龙卷风
电视中继采访	电视采访
土地使用管理	土地利用管理
防台	防台风
划拨土地	划拨用地	土地征用
国家金库管理	国库管理
保密守则	保密规定
药流	药物流产
婚庆服务	喜庆服务
执勤对象	执勤目标
党建	党的建设
辩证唯物论	辩证唯物主义
邮政包裹	包裹
国画	中国画
军队干部退役安置	退役安置
军援顾问团	军事顾问团
外经贸	对外经济贸易
高空脊	高压楔
儿歌	儿童歌曲
黄梅雨	梅雨
会议议题	议题
急性呼吸系统综合症	非典
作战物资贮备	作战物资储备
人民防空建设	人防建设
精神奖励	精神鼓励
特种经济林	经济林
局务会议	局委会
卫生勤务机构	卫勤机构
事业单位审计	行政事业审计
纪检委	纪委
商业产品加工	商业加工
军队文化艺术	军队文艺
社教运动	社会主义教育运动
冻结降水	雨凇
大常规冲突	常规战争
沙旋	沙尘暴
野战军	野战部队
品种资源	种质资源
互连网	互联网
收支	收支挂钩
欺骗性干扰	欺骗性电子干扰
兵制	军制
侨务	侨务工作
防沙治沙	风沙防治
尸体检查	尸检
社会主义教育运动	社教
宣作鼓动	宣传
爱滋病	艾滋病
杀手锏武器	杀手锏装备
民兵战术训练	民兵训练
C2系统	指挥控制系统
核生化防护训练	三防训练
马克思主义辩证法	唯物辩证法
军工产品	军品
科技保密	技术保密
采煤工业	煤炭开采业
境内游	国内旅游
巡逻警察	巡警
国企	国有企业
非法越境	越境
会计法规	会计法
军费开支	国防支出
税	税种
无产阶级文化大革命	文革
中国与欧盟关系	中欧关系
航天器制造业	航天工业
国防意识	国防观念
学生军事训练制度	学生军训制度
国家贮备	国家储备
沿江	沿江地区
注会	注册会计师
电报通信	电报
防空袭	防空
地下水位降落漏斗	漏斗
西医	现代医药学
大头菜	甘蓝
航摄	航空摄影测量
贿赂	行贿
保函	保价函件
白果	银杏
议席	议会席位
吸引外资	利用外资
卫生检疫	检疫
英林匹克运动会	奥运会
全民所有制商业	国有商业
火箭部队通信	导弹部队通信
商品储备库	仓库
仔免权限	任免权
擅自离认	私自离队
禁伐禁猎区	自然保护区
珍贵野生动物	珍稀野生动物
石油输出国组织	欧佩克
工作宗旨	工作目的
药物副反应	药物不良反应
处理设备	处理装备
野外驻训	野营训练
空管	空中管制
武器装备调整	装备调整
武器装备质检	装备质检
国际儿童节	六一儿童节
封山	封山育林
台海关系	两岸关系
军队群众工作	群众工作
音频电报	载波电报
飞行管制建设	空管建设
灾情调查	灾害调查
抽样	采样
小震	有感地震
归国侨民	归侨
赤道槽	热带辐合带
财团法人海峡交流基金会	海基会
人民来信来访	信访
铁路货车	货物列车
装备发展管理	装备研制管理
民政	抚恤费
总金额	总额
和平统一祖国	和平统一问题
全国人民代表大会常委委员会委员长	委员长
薪水	工资
原始凭证	会计凭证
小规模战争	局部战争
清洗机	洗衣机
地对地导弹	地地导弹
核工	核工业
祖国和平统一问题	和平统一问题
国家安全战略	国防战略
蜕化变质	腐败
科技领域	科研领域
气象资料处理	气象资料加工
财产所有权	产权
统一战线理论	统战理论
军事制度研究	军制研究
葬法	丧葬
花房效应	温室效应
主题词表	叙词表
国家军事领导体制	国防领导体制
电讯	电信
特资	特种物资
客运船	客船
军事科学研究机构	军事科研机构
牙商	中介
基建贷款	基本建设贷款
养老院	敬老院
违犯政治纪律	违反政治纪律
社会团体	社团
农机	农业机械
试制计划	研制计划
沿海捕捞	近海捕捞
武器采购	武器装备采购
能源林	薪炭林
防暑降温	中暑预防
情报检索	检索
无霜冻期	无霜期
大气保温效应	温室效应
乘警(航运)	港航警察
铁路道口	道口
能交基金	能源交通基金
盘货	盘点
会议材料	会议资料
考察报告	调查报告
行政记大过	记大过
专审	专项审计
军警纠纷	军地纠纷
比丘	和尚
盐田地	盐田用地
动员部队	预备役部队
军委纪律检查委员金	军队纪律检查委员会
化工	化学工业
录像器材	录像设备
旅客机	客机
地方病预防	地方病防治
证券交易中心	证券交易所
奥林匹克运动会	奥运会
百家争鸣	双百方针
军种	军兵种
消减	裁减
违规行为	违反规定
空中情况处置	空情处置
军费	国防费
工业白蚁	工业间谍
浴室	淋浴设施
旅游林	风景林
汪伪档案	汪伪政权档案
劳动改造	劳改
税目	税种
军队史	军史
内线关系	内线
原子能	核能	核能源
沙暴	沙尘暴
造船工业	船舶工业
测试仪	测试仪器
中央组织部	中组部
为政清廉	廉政
信函	信件
军队纪律教育	军纪教育
适龄青年	役龄青年
坏账	呆账
冻害	冻灾
水产业	渔业
交接书	交接文据
功勋奖章	勋章
电子反侦察	反电子侦察
现代化战争	现代战争
武警服装	警服
归国华侨	归侨
民用航空	民航
名词术语	术语
IT业	信息产业
研究试验费	科研试验费
工业品	工业产品
审计准则	审计标准
战备预案	战备方案
外交使节	外交官员
塑料大棚	塑料拱棚
军队群众工作部门	军队群工部门
工业搬迁	工业疏散
学生联合会	学联
押解罪犯	武装押解
寺院	寺庙
人身自由权	人身权
行政管理法	行政法
历史唯物论	历史唯物主义
快递业务	速递业务
调水	水资源调度
全面调查	普查
造型艺术	美术
特区	特别行政区
民盟	中国民主同盟
县人民法院	基层人民法院
党内法规	党规
港资企业	港澳台商企业
防务开支	国防支出
后勤自动化指挥系统	后勤指挥自动化系统
荣誉军人	残疾军人
地面站设备	地球站设备
税收对象	科税对象
计划收购	统购
军费支出	国防支出
议事日程	议程
批发价格	批发价
国家民族事务委员会	国家民委
技术职务	专业技术职务
基建	基本建设
综合安全保障战略	国家战略
边民	边境居民
中国工农红军	红军
运动馆	体育馆
晾晒烟叶	晾晒烟
印度支那问题	印支问题
邮费	邮政资费
运输力	运输能力
强热带风暴	台风
试飞	飞行试验
国家形式	政治制度
距离测量	测距
沉船	沉船事故
住宿业	旅馆业
防汛	防洪
情报检索语言	检索语言
边境地区	边境
革命烈士	烈士
配合	合作
石油化工	石油化学工业
物资流通	物资交流
黄毛风	沙尘暴
需求调节	供需调节
代议制	议会制
士兵	兵
船只	船舶
民族习俗	民族风俗
币制	货币制度
人民防空指挥部	人防指挥部
军工	国防工业
狱证管理	监狱管理
龙吊水	水龙卷
定容气球	定高气球
增殖业务	增值业务
可转换债	转换债券
干旱灾害	旱灾
社会情况动态	社会动态
残儿	残疾儿童
统一销售	统销
海潮	潮汐
押解囚犯	武装押解
纺织业	纺织工业
军事法律	军事法
采油设备	油气开采设备
居委会	居民委员会
中央对外联络部	中联部
施政报告	工作报告
特派员办公室	特派办
政府审计	国家审计
电子支援措施	电子对抗支援侦察
政法	政法工作
护林防火	森林防火
出霉	出梅
无线寻呼	无线寻呼业务
货场	货栈
国庆	国庆节
热核战争	核战争
伤残等级评定	伤病残评定
指挥控制通信系统	C3系统
旅游卫生	旅游保健
演出证	演出许可证
电视文学	影视文学
国有参股	国有股
防空袭系统	防空系统
白害	雪灾
防范	防范措施
案件审理	案审
关税及贸易总协定	世界贸易组织
农膜	农用薄膜
立梅	入梅
撤销案件	销案
军械	军械装备
民防工事	民防工程
风灾	风害
深海捕捞	远洋捕捞
武器装备事故	装备事故
文件种类	文种
风景游	山水旅游
学习先进	学先进活动
财产权	产权
战功奖章	军功章
组织干部纪检	军纪
副作用	药物不良反应
国防白皮书	国防报告
国民经济动员	经济动员
侨办	侨务办公室
军事理论、学术	边境战争
潜艇发射导弹	潜射导弹
债务凭证	债券
中央书记处	书记处
处置突发事件任务划分	处突任务
殖民战争	侵略战争
军事通信联络	军事通信
细菌防护	生物武器防护
轮换作战	轮战
税务收入	税收
伤残军人	残疾军人
财会	财务会计
传媒	媒体
森警	森林警察
葱头	洋葱
战备交通建设	交通战备建设
计算利息	计息
高技术兵路	高技术武器
出巡	巡视
台消回归祖国问题	和平统一问题
邮政运输网	邮运网
契约	合同
煤转换	煤转化
传真通信	传真
邮运网点	邮政运输网点
内政	国内政治
武警部队勤务	武警勤务
林彪叛逃事件	九一三事件
股份制公司	股份公司
收受贿赂	受贿
军事犯罪人	军事罪犯
基本建设投资	基建投资
空间无线电通信	卫星通信
编辑(业务)	编辑工作
红潮	赤潮	赤湖
运价	运输价格
营区警卫	军营警卫
以权谋私	以权谋私行为
报亏	盘亏
公款公物请客送礼	请客送札
软件	软件开发
智能武器	重武器
法制	法律制度
外国军队研究	外军研究
排雷	扫雷
预先电子对抗侦察	电子对抗情报侦察
军婚	军人婚姻
民建	中国民主建国会
外国武装力量	外军
转基因	基因转移
下渗	入渗
体制创新	体制改革
后方勤务指挥	后勤指挥
工作经验	经验
光学对抗侦察	光电对抗侦察
粮食收储	粮食储备
军地关系	军政关系
第二炮兵专用装备	二炮专用装备
传染性非典型肺炎	非典
人犯	犯罪嫌疑人
农产品贸易	农贸
干燥因子	干燥指数
国货	本国商品
武器装备规划	武器装备发展规划
运量	运输量
高技术产业	高新技术产业
海外侨胞	华侨
科研课题	科研项目
航空运输	空中运输
免于起诉决定书	免于起诉书
合作经营企业	合作企业
法律监督机关	国家检察机关
三八妇女节	国际劳动妇女节
价格改革	物价改革
法警	司法警察
洋流	海流
军风纪	军容风纪
地面保障设备	地面设备
空气污染气象学	污染气象学
诽谤	诬陷
大规模毁灭性武器	大规模杀伤性武器
科教兴省	科教兴国战略
正常体制	平时体制
人事	人事工作
平息闹事	制止闹事
军队指挥自动化	指挥自动化
倒卖	倒买倒卖
邮电通信	邮电
蜂窝网	蜂窝式移动通信网
抄件	抄送件
犯罪分子	罪犯
交换机	电话交换机
党纪检查	纪检
装备保障、管理	报废装备
现金计划	现金收支计划
文艺批评	文艺评论
民谣	民歌
电子购买	电子采购
处置突发事件命令	处突命令
海上战役	海军战役
学先进	学先进活动
敌伪档案	旧政权档案
冒险旅游	探险旅游
药厂	制药厂
三军统供	联勤
政府机构	政府部门
安定性	稳定性
远景	发展趋势
领航	导航
白毛风	雪暴
市场调控	市场调节
经济体制改革办公室	体改办
地球环境产业	环保产业
技术力量	科技力量
投案	投案自首
税收征收管理法	税收征管法
离休金	离休费
废品回收	废旧物资回收
中国共产党中央委员会	中共中央
人民政协	政协
测试仪表	测试仪器
农村人口	农业人口
购买能力	购买力
体操	体操运动
国家机关	国家机构
强权政治	霸权主义
技术出口	技术转让
流域综合规划	流域规划
放射战	核战争
洋行	银行
新技术	高新技术
治理经济环境	经济环境治理
严重急性呼吸综合症	非典
人民防空经费	人防经费
专业人才	专家
传染病防治	传染病控制
